12345678901234567890
11111111111111111111
1                  1
1  11111111111111111
1  11111111111111111
1                  1
1111111111111111   1
11111111111111     1
111111111111       1
11111111111        1
11111111111        1
11111111111        1
111111111111111    1
111111111111111    1
111111111111111    1
111111111111111  111
111111111111111  111
111111111111111  111
111111111111111  111
11111111111111   111
11111111111111EEE111