12345678901234567890
11111111111111111111
1                  1
E                  1
E                  1
1                  1
1    11            1
1    11            1
1                  1
1           11     1
1           11     1
1                  1
1                  1
1                  1
1       11         1
1       11         1
1                  1
1                  1
1                 S1
1                  1
11111111111111111111